WWWWWWWWWWWWWWWWWWWWWWWWWWW
WP D DD DDD DDD DDD DD D PW
W D  D   D   D   D   D KD W
WD W D W D W D W D W D W DW
WDPPPPPPPPPPPPPPPPPPPPPPPDW
WDW W W W W WJW W W W W WDW
WD  K                    DW
WD W D W D W D W D W D W DW
W D  D   D   D   D   D MD W
WP D DD DDD DDD DDD DD D PW
WWWWWWWWWWWWWWWWWWWWWWWWWWW